1111111111
1111000001
1C11001001
1011100101
1011M10111
1000001111
1C10100111
1011100111
1PE1011011
1111111111