1111111
10CM001
1P1ECC1
1011101
1000001
1111111