1111111111
11110E0P01
1C11011001
100000M001
1111111111